...............@
........@@@....@
.......@.......@
......@........@
.....@.........@
....@..........@
@@@@@@@@@@@@@@@@
