.................
.................
.................
..........@@@@@@@
@@@@@@@@@@@@@@@@@